12
10
1 1 1 1 1 1 1 1 1 1 1 1 
1 1 1 1 1 1 1 1 1 1 1 1 
1 1 20 20 1 1 1 1 1 1 1 1 
1 1 20 20 1 1 1 1 1 20 20 1 
1 1 1 1 1 1 1 1 1 20 20 1 
1 1 1 1 1 1 1 1 1 1 1 1 
1 1 1 1 1 21 21 1 1 1 1 1 
1 1 1 1 1 21 21 1 1 1 1 1 
1 1 1 1 1 1 1 1 1 1 1 1 
1 1 1 1 1 1 1 1 1 1 1 1 
