54
30
48 48 48 48 48 48 48 48 48 48 48 48 48 48 48 48 48 48 48 48 48 48 48 48 48 48 48 48 48 48 48 48 48 48 48 48 48 48 48 48 48 48 48 48 48 48 48 48 48 48 48 48 48 48 
48 48 48 48 48 48 48 48 48 48 48 48 48 48 48 48 48 48 48 48 14 48 48 48 48 48 48 48 48 48 48 48 48 14 14 14 14 14 14 14 14 36 14 14 14 14 14 14 48 48 48 48 48 48 
48 48 48 48 48 48 48 48 48 48 48 48 14 14 14 48 48 48 48 14 15 14 14 48 48 48 48 48 48 48 48 14 14 15 15 15 15 7 15 15 15 36 15 15 15 16 16 16 16 14 14 48 48 48 
48 48 48 48 48 48 48 48 14 14 14 14 31 31 31 14 14 14 14 15 15 15 31 14 48 48 48 48 48 48 14 15 15 16 31 35 7 7 7 7 7 36 7 7 7 7 7 15 16 15 15 48 48 48 
48 48 48 14 14 14 14 14 15 15 15 17 17 17 17 17 17 15 15 15 15 15 15 15 14 48 48 48 48 14 15 16 16 15 7 7 7 7 41 41 7 7 7 7 7 7 7 7 7 15 15 14 48 48 
48 48 14 15 15 15 15 15 15 15 15 15 17 15 15 15 15 15 15 15 17 15 15 15 15 14 48 14 14 15 16 16 15 15 7 7 7 41 41 7 7 7 7 7 41 41 7 7 7 7 7 15 48 48 
48 48 15 15 15 15 15 15 17 17 17 17 17 16 15 15 15 15 15 15 17 17 17 15 15 15 15 15 16 16 15 15 15 15 7 7 7 7 7 7 38 29 38 38 38 37 38 38 38 38 38 7 18 48 
48 14 15 15 15 17 17 17 15 15 15 16 16 16 15 15 15 15 15 15 15 17 17 15 15 15 16 16 16 15 15 15 15 15 7 7 7 7 7 7 7 7 7 7 7 7 7 7 7 41 41 41 48 48 
48 15 15 15 15 15 15 15 15 15 16 16 18 18 18 15 15 15 15 15 17 17 15 15 15 15 15 15 15 15 15 15 15 15 41 7 7 38 38 29 7 7 7 7 7 7 7 7 38 38 37 41 48 48 
48 15 31 15 15 15 15 15 16 16 16 18 48 48 48 15 15 15 17 17 17 15 15 15 15 15 15 15 15 15 15 31 15 15 41 7 7 7 7 36 7 7 7 7 7 7 7 7 7 7 7 7 14 48 
48 15 15 17 17 15 15 16 16 16 18 48 48 48 48 18 18 17 17 15 15 15 15 15 15 15 15 15 15 15 15 31 31 15 41 41 7 7 7 36 7 7 7 7 7 7 7 7 7 7 7 7 15 48 
48 15 15 15 17 15 15 16 16 16 48 48 48 48 48 48 48 18 15 15 15 15 15 17 17 15 15 15 15 15 15 31 35 15 7 41 41 14 7 7 7 7 7 7 7 7 7 35 7 7 7 15 18 48 
48 15 15 15 17 15 16 16 16 16 48 48 48 48 48 48 48 48 15 15 15 17 17 17 17 17 17 15 15 15 15 15 15 15 15 7 7 7 7 7 7 7 15 15 7 7 7 41 41 7 15 15 48 48 
48 15 15 15 17 15 16 16 16 16 48 48 48 48 48 48 48 48 15 15 17 15 17 17 17 17 17 15 15 15 15 15 15 15 15 15 7 7 7 7 7 15 15 17 7 7 41 41 7 15 15 15 48 48 
48 15 15 15 15 15 15 16 16 16 14 48 48 48 48 48 48 48 15 17 17 17 17 17 17 17 17 17 15 15 15 15 31 15 15 15 15 15 15 7 7 15 17 17 15 7 15 15 17 17 17 15 14 48 
48 18 15 15 15 15 16 16 16 16 15 14 14 14 14 14 14 14 15 17 17 17 17 15 15 15 15 15 15 15 15 15 15 15 31 15 15 15 15 15 31 15 17 17 15 15 17 17 17 15 15 15 15 48 
48 48 18 15 16 16 15 15 15 15 15 15 15 15 15 15 15 15 31 15 17 15 15 15 15 15 15 15 15 15 15 15 15 15 15 15 31 15 15 15 15 15 17 17 17 17 17 15 15 15 15 15 18 48 
48 48 48 18 15 15 15 15 15 15 15 17 15 15 15 15 15 15 15 15 17 15 15 15 15 15 15 15 15 15 15 15 16 16 16 16 15 15 15 15 15 15 15 17 17 15 15 15 15 15 15 18 48 48 
48 48 48 48 31 15 15 15 15 17 17 15 15 31 15 15 15 15 17 17 17 17 17 17 17 31 15 15 15 15 15 16 16 16 16 16 16 16 15 15 15 15 15 15 15 15 16 16 16 16 15 48 48 48 
48 48 48 48 31 15 15 15 17 17 15 15 15 31 15 15 15 17 17 15 17 17 17 15 17 15 15 15 15 15 16 16 15 15 15 15 16 16 16 15 15 15 15 15 15 15 16 16 16 16 15 15 48 48 
48 48 48 48 31 31 31 15 17 17 17 17 17 17 17 15 15 15 15 17 17 15 17 15 15 15 15 15 15 15 16 15 15 15 15 15 15 15 15 15 15 15 15 15 15 16 16 16 15 15 15 31 48 48 
48 48 48 48 31 31 31 15 15 17 15 15 15 15 15 15 15 15 15 15 15 15 15 17 17 17 15 15 15 15 15 15 15 15 15 15 15 15 15 15 15 15 15 15 15 16 16 15 15 15 15 31 48 48 
48 48 48 48 15 31 31 31 31 17 17 15 15 15 15 15 15 15 15 15 15 15 15 15 15 17 17 17 15 15 15 15 15 15 15 15 15 15 31 15 15 15 15 15 15 16 15 15 15 31 31 18 48 48 
48 48 48 48 15 18 15 31 15 15 17 17 17 15 17 17 15 16 16 16 16 15 15 15 15 15 15 15 15 15 15 31 15 15 18 18 18 15 15 15 15 15 15 15 16 16 15 15 15 18 18 48 48 48 
48 48 48 14 15 48 15 31 15 15 15 15 15 17 17 15 16 16 15 16 15 15 15 15 15 15 15 15 15 31 31 18 18 18 48 48 48 15 15 15 15 15 15 17 15 15 15 15 18 48 48 48 48 48 
48 48 48 18 18 48 18 31 15 15 15 15 15 15 15 16 16 15 15 15 15 15 15 15 15 18 18 18 18 18 18 48 48 48 48 48 18 18 18 18 18 15 31 17 17 15 15 18 48 48 48 48 48 48 
48 48 48 48 48 48 48 18 18 18 15 15 15 15 15 16 15 15 15 15 15 15 15 18 18 48 48 48 48 48 48 48 48 48 48 48 48 48 48 48 48 18 18 15 17 15 18 48 48 48 48 48 48 48 
48 48 48 48 48 48 48 48 48 48 15 18 18 18 18 15 15 18 18 18 18 18 18 48 48 48 48 48 48 48 48 48 48 48 48 48 48 48 48 48 48 48 48 18 18 18 48 48 48 48 48 48 48 48 
48 48 48 48 48 48 48 48 48 48 18 48 48 48 48 18 48 48 48 48 48 48 48 48 48 48 48 48 48 48 48 48 48 48 48 48 48 48 48 48 48 48 48 48 48 48 48 48 48 48 48 48 48 48 
48 48 48 48 48 48 48 48 48 48 48 48 48 48 48 48 48 48 48 48 48 48 48 48 48 48 48 48 48 48 48 48 48 48 48 48 48 48 48 48 48 48 48 48 48 48 48 48 48 48 48 48 48 48 
