60
30
23 23 23 23 23 24 23 23 23 23 24 23 32 23 23 24 23 23 23 23 24 23 23 23 23 24 23 23 32 23 24 23 23 23 23 23 24 23 23 23 23 23 23 23 24 23 23 23 23 24 23 32 24 23 23 24 23 23 23 23 
7 7 1 1 7 7 7 7 7 7 1 1 31 7 7 7 7 7 7 7 7 7 7 1 21 21 21 21 30 7 7 7 7 7 7 7 7 7 7 7 7 7 36 36 7 7 7 7 7 7 7 31 7 7 7 7 7 36 36 36 
7 21 1 1 1 1 7 1 1 1 21 1 31 7 7 7 7 7 7 7 7 7 7 1 21 1 1 1 7 7 7 7 7 7 7 7 7 7 7 7 7 7 7 36 36 7 7 7 7 7 7 31 7 7 7 7 7 7 7 36 
7 1 28 28 28 1 1 1 1 7 1 7 35 33 33 36 33 33 33 7 7 7 7 7 1 1 1 7 7 7 7 7 7 7 7 7 7 7 7 7 7 7 7 7 36 36 7 7 7 7 7 31 7 7 11 13 13 12 7 7 
1 1 28 28 28 28 28 28 1 7 7 7 7 7 7 7 7 7 7 7 7 7 7 7 7 1 1 7 31 7 7 7 7 7 7 7 7 7 7 7 7 7 7 7 7 36 7 7 7 36 36 31 7 7 8 9 9 10 7 7 
1 1 28 28 28 28 28 28 1 1 7 7 7 7 7 7 7 7 7 7 7 7 7 7 7 7 7 7 31 7 7 7 7 7 7 7 7 7 7 7 7 7 7 7 7 7 7 36 36 36 36 31 7 7 7 7 7 7 7 7 
7 1 28 28 28 28 28 28 1 1 7 7 37 33 33 36 33 33 34 7 7 11 13 12 7 7 7 7 31 7 7 7 7 7 7 7 7 7 7 7 7 7 7 7 7 7 7 36 36 7 36 31 7 7 7 7 7 7 7 7 
7 1 1 1 1 28 28 28 1 7 7 7 31 7 7 7 7 7 7 7 7 8 9 10 7 7 7 7 31 7 7 7 7 7 7 7 7 7 7 7 7 7 7 7 7 7 7 7 7 36 36 31 7 7 1 1 1 7 7 7 
7 7 7 1 1 1 1 1 1 7 7 7 31 7 7 7 7 7 7 7 7 7 7 7 7 7 7 7 31 7 7 7 7 7 7 7 7 7 7 7 7 7 7 7 7 7 7 7 7 36 36 31 7 1 1 2 1 7 7 7 
7 7 7 7 7 7 7 7 7 7 7 7 31 7 7 7 7 7 7 7 7 7 7 7 7 7 7 7 31 7 7 7 7 7 7 7 7 7 7 7 7 7 7 7 7 7 7 36 36 36 36 31 7 1 2 20 1 1 7 7 
33 33 33 36 33 33 33 33 36 33 33 33 32 33 33 33 36 33 33 33 33 33 33 33 33 36 33 33 33 33 33 33 36 33 33 11 13 13 13 12 33 33 33 33 33 36 33 33 33 33 33 34 1 2 20 20 2 1 1 7 
7 7 7 7 7 7 7 7 7 7 7 7 31 7 7 7 7 7 7 7 7 7 7 7 7 7 7 7 7 7 7 7 7 7 7 8 9 9 9 10 7 7 7 7 7 7 7 7 7 7 1 1 1 20 20 20 20 1 1 7 
7 7 7 7 7 7 7 7 7 7 7 37 34 7 7 7 7 7 7 7 7 7 7 7 7 7 7 7 7 7 7 7 7 7 7 7 7 7 7 7 7 7 7 7 7 7 7 7 7 1 1 1 5 20 20 20 20 2 1 7 
7 7 7 7 7 7 7 7 7 7 7 31 7 7 7 7 7 7 7 7 7 7 7 7 7 7 7 7 7 7 7 7 7 7 7 7 7 7 7 7 7 7 7 7 7 7 7 7 1 1 1 1 1 3 20 20 20 20 1 1 
7 7 7 7 7 7 7 7 7 7 7 31 7 7 7 7 7 7 7 7 7 7 7 7 7 7 7 7 7 7 7 7 7 7 7 7 7 7 7 7 7 7 7 7 7 7 7 1 1 1 1 1 1 1 5 20 20 20 2 1 
7 7 7 7 7 7 7 7 7 7 7 30 7 7 7 7 7 1 1 7 7 7 7 7 7 7 7 7 7 7 7 7 7 7 7 7 7 7 7 7 7 7 7 7 7 7 7 7 7 1 1 1 1 2 20 20 20 20 20 6 
7 7 7 7 7 7 7 7 7 7 7 7 7 7 7 7 1 1 1 1 1 21 1 1 21 1 7 7 7 7 7 7 7 7 7 7 7 7 7 7 7 7 7 7 7 7 7 7 7 1 1 1 5 20 20 20 20 20 20 6 
7 7 7 7 7 7 7 7 7 7 7 7 7 7 7 21 1 1 1 1 2 2 2 2 1 1 1 1 1 1 1 7 7 7 7 7 7 7 7 7 7 7 7 7 7 7 7 7 7 7 1 1 1 1 3 3 3 3 3 1 
7 7 7 7 7 7 7 7 7 7 7 31 7 7 1 1 1 1 2 28 28 28 28 28 2 1 1 2 2 1 1 1 1 7 7 7 7 7 7 7 7 7 7 7 7 7 7 7 7 7 7 1 1 1 7 7 1 7 7 1 
7 7 7 7 7 7 7 7 7 7 7 31 1 1 1 2 2 28 28 28 28 28 28 28 28 2 2 28 28 2 2 1 1 1 7 7 7 7 7 7 7 7 7 7 7 7 7 7 7 7 7 7 7 7 7 7 7 7 7 7 
7 7 7 7 7 7 7 7 7 7 7 31 1 2 28 28 28 28 28 28 28 28 28 28 28 28 28 28 28 28 28 2 1 1 7 7 7 7 7 7 7 7 7 7 7 7 7 7 7 7 31 7 7 7 7 7 7 7 7 7 
36 36 7 7 7 7 7 7 7 7 7 31 1 28 28 28 28 28 28 28 28 28 28 28 28 28 28 28 28 28 28 28 1 1 7 7 7 7 7 7 7 7 7 7 7 7 7 7 7 7 31 7 7 7 7 7 7 7 7 7 
36 36 7 36 7 7 7 7 7 7 7 31 1 3 3 28 28 28 28 28 28 28 28 28 28 28 28 28 28 28 28 28 1 1 7 7 7 7 7 7 7 7 7 7 7 7 7 7 7 7 35 33 36 33 33 33 33 33 36 33 
36 36 36 36 36 36 7 7 7 7 7 31 1 1 1 28 28 28 28 28 28 28 28 28 28 28 28 28 28 28 28 3 1 1 7 7 7 7 7 7 7 7 7 7 7 7 7 7 7 7 7 7 7 7 7 7 7 7 7 7 
36 36 36 36 36 36 7 7 7 7 7 31 7 1 21 1 3 28 28 28 28 28 28 28 28 28 28 28 28 28 3 1 1 7 7 7 7 7 7 7 7 7 7 7 7 7 7 7 7 7 7 7 7 7 7 7 7 7 7 7 
36 36 36 36 36 36 36 36 7 7 7 31 7 7 7 1 1 3 3 28 28 28 28 28 28 28 3 3 3 1 1 1 7 7 7 7 7 7 7 7 7 7 7 7 7 7 7 7 7 7 7 7 7 7 7 7 7 7 7 7 
36 36 36 36 36 36 36 36 7 7 7 31 7 7 7 1 1 1 1 3 3 3 28 28 28 28 6 21 1 1 7 7 7 7 7 7 7 7 7 7 7 7 7 7 7 7 7 7 7 7 7 7 7 7 7 7 7 7 7 7 
36 36 36 36 36 36 36 36 36 36 7 31 7 7 7 7 7 7 1 1 1 1 3 3 3 3 1 1 7 7 7 7 7 7 7 7 7 7 7 7 7 7 7 7 7 7 7 7 7 7 7 7 7 7 7 7 7 7 7 7 
36 36 36 36 36 36 36 36 36 36 36 31 7 7 7 7 7 7 7 7 7 7 7 7 7 7 7 7 7 7 7 7 7 7 7 7 7 7 7 7 7 7 7 7 7 7 7 7 7 7 7 7 7 7 7 7 7 7 7 7 
22 22 22 22 22 22 22 22 22 22 22 22 22 22 22 22 22 22 22 22 22 22 22 22 22 22 22 22 22 22 22 22 22 22 22 22 22 22 22 22 22 22 22 22 22 22 22 22 22 22 22 22 22 22 22 22 22 22 22 22 
