20
15
28 28 28 28 28 28 28 28 28 28 28 28 28 28 28 28 28 28 28 28 
28 28 28 28 28 28 26 25 25 28 28 28 28 28 28 28 28 28 28 28 
28 28 28 28 25 26 9 10 26 26 26 26 26 26 26 26 25 26 28 28 
28 28 28 25 26 25 29 30 27 26 26 26 26 26 26 26 26 26 26 26 
28 25 26 26 26 26 26 26 26 26 27 27 26 26 26 26 25 25 26 26 
28 25 26 26 26 26 26 26 26 27 27 26 26 26 26 26 26 26 26 26 
28 28 26 26 26 26 26 26 26 26 26 26 26 26 26 26 26 26 26 26 
28 28 26 26 26 26 26 25 25 25 26 26 26 26 26 26 26 27 27 26 
28 25 26 26 26 26 26 26 26 26 26 26 26 26 26 26 26 27 27 26 
28 28 26 26 26 26 26 26 26 26 26 26 26 26 25 26 26 27 26 26 
28 25 26 26 26 26 26 26 26 26 26 26 26 26 26 26 26 26 26 26 
28 28 26 26 26 26 26 26 27 27 27 26 26 26 26 26 26 26 26 26 
28 28 26 26 26 26 26 26 26 26 27 26 26 26 26 26 26 26 26 26 
28 28 25 26 26 26 26 26 26 26 25 26 26 26 26 26 26 26 26 26 
0 0 0 0 0 0 0 0 0 0 0 0 0 0 0 0 0 0 0 0 
