34
22
28 28 28 28 28 28 28 28 28 28 28 28 28 28 28 28 28 28 28 28 28 28 28 28 28 28 28 28 28 28 28 28 28 28 
28 28 28 28 28 28 28 28 28 28 28 28 28 28 28 28 28 28 28 28 28 28 28 28 28 28 28 28 28 28 28 28 28 28 
26 26 28 28 28 28 28 26 26 26 26 26 26 26 26 26 28 28 28 28 28 28 28 28 28 28 28 28 26 26 26 28 28 28 
26 27 26 26 28 28 26 26 26 26 26 27 26 26 26 26 26 26 28 28 28 28 28 28 26 26 26 26 27 26 28 28 28 28 
26 26 26 26 28 26 26 26 26 26 26 26 26 26 26 27 26 26 28 28 28 28 28 26 26 26 26 26 26 26 28 28 28 28 
28 26 26 27 26 26 26 26 26 26 26 26 26 26 26 26 26 26 28 28 28 26 26 26 26 25 25 26 26 26 28 28 28 28 
28 26 26 26 26 26 26 26 25 25 26 26 26 26 26 26 26 26 26 26 26 26 26 26 26 26 25 26 26 26 28 28 28 28 
28 28 26 26 26 27 26 26 26 25 26 27 26 26 26 26 27 26 26 26 26 26 26 26 26 26 26 26 26 26 28 28 28 28 
28 28 28 26 26 26 26 26 26 26 26 26 26 26 26 26 26 26 9 10 26 26 26 26 26 27 26 27 26 26 28 28 28 28 
28 28 26 26 26 26 26 27 26 21 21 26 26 26 26 26 26 26 29 30 26 26 26 21 21 26 26 26 26 26 28 28 28 28 
28 28 26 26 26 26 26 26 26 21 21 21 26 26 26 26 26 26 26 26 26 26 21 21 21 21 26 26 26 26 26 28 28 28 
28 28 26 26 26 26 26 21 21 21 21 21 21 26 26 26 26 26 26 26 21 21 21 21 21 26 26 26 26 26 26 28 28 28 
26 26 26 26 26 27 26 21 21 21 21 26 26 26 25 26 26 26 26 26 21 21 21 21 21 27 26 26 26 26 26 28 28 28 
28 26 26 26 26 26 26 26 26 21 27 26 26 26 26 26 26 26 26 21 21 21 21 21 21 26 26 26 25 26 26 28 28 28 
28 26 26 26 26 26 26 26 26 26 26 26 26 26 25 27 26 26 26 26 26 21 21 21 21 21 26 25 26 26 26 26 28 28 
28 28 26 26 26 26 26 26 26 26 26 26 26 25 26 26 26 26 26 26 26 21 21 21 26 26 26 25 26 27 26 26 26 28 
28 28 26 26 26 26 26 26 26 26 26 26 25 26 26 26 26 26 25 26 26 26 26 25 26 26 26 26 26 26 28 26 26 28 
28 28 26 26 26 26 26 26 27 26 26 26 26 26 26 26 26 26 26 26 25 26 26 26 26 26 26 26 26 26 28 26 28 28 
28 28 26 26 27 26 26 26 26 26 26 26 26 26 26 26 26 26 26 26 28 28 28 28 28 28 28 28 26 28 28 28 28 28 
28 26 26 26 26 26 26 26 26 26 28 28 28 28 28 28 28 28 28 28 28 28 28 28 28 28 28 28 28 28 28 28 28 28 
26 26 27 26 27 26 26 26 26 26 26 28 28 28 28 28 28 28 28 28 28 28 28 28 28 28 28 28 28 28 28 28 28 28 
26 26 26 26 26 26 26 26 26 26 28 28 28 28 28 28 28 28 28 28 28 28 28 28 28 28 28 28 28 28 28 28 28 28 
