20
15
1 1 1 1 1 1 1 1 1 1 1 1 1 1 1 1 1 1 1 1 
1 1 1 1 1 1 1 1 1 1 1 1 1 1 1 1 1 1 1 1 
1 1 1 1 1 1 1 1 1 1 1 1 1 1 1 1 1 1 1 1 
1 1 1 1 1 1 1 1 1 1 1 1 1 1 1 1 1 1 1 1 
1 1 1 1 1 1 1 1 1 1 1 1 1 2 2 1 1 1 1 1 
1 1 1 1 1 1 1 1 1 1 1 1 2 28 28 6 1 1 1 1 
1 1 1 1 1 1 1 1 1 1 1 2 28 28 28 6 1 1 1 1 
1 1 1 1 1 1 1 1 1 2 2 28 28 28 28 6 1 1 1 1 
1 1 1 1 1 1 1 1 5 28 28 28 28 28 28 6 21 21 1 1 
1 1 1 1 1 1 1 1 1 3 3 28 28 3 3 21 21 21 1 1 
1 1 1 1 1 1 1 1 1 1 1 3 3 1 21 21 21 21 1 1 
1 1 1 1 1 1 1 1 1 1 1 1 1 1 1 1 21 21 1 1 
1 1 1 1 1 1 1 1 1 1 1 1 1 1 1 1 1 1 1 1 
2 2 2 2 2 2 2 2 2 2 2 2 2 2 2 2 2 2 2 2 
20 20 20 20 20 20 20 20 20 20 20 20 20 20 20 20 20 20 20 20 
