20
15
20 20 20 20 20 20 20 20 20 20 20 20 20 20 20 20 20 20 20 20 
20 20 20 20 20 20 20 20 20 20 20 20 20 20 20 20 20 20 20 20 
20 20 20 20 20 20 20 20 20 20 20 20 20 20 20 20 20 20 20 20 
20 20 3 3 3 3 3 3 3 3 3 3 20 20 20 20 20 20 20 20 
20 20 1 1 1 1 1 1 1 1 1 1 20 20 20 20 20 20 20 20 
20 20 1 1 1 1 1 1 1 1 1 1 20 20 20 20 20 20 20 20 
20 20 1 1 1 1 1 1 1 1 1 1 20 20 20 20 20 20 20 20 
20 20 1 1 1 1 1 1 1 1 1 1 20 20 20 20 20 20 20 20 
20 20 1 1 1 1 1 1 1 1 1 1 20 20 20 20 20 20 20 20 
20 20 1 1 1 1 1 1 1 1 1 1 20 20 20 20 20 20 20 20 
20 20 1 1 1 1 1 1 1 1 1 1 20 20 20 20 20 20 20 20 
20 20 2 2 2 2 2 2 2 2 2 2 20 20 20 20 20 20 20 20 
20 20 20 20 20 20 20 20 20 20 20 20 20 20 20 20 20 20 20 20 
20 20 20 20 20 20 20 20 20 20 20 20 20 20 20 20 20 20 20 20 
0 0 0 0 0 0 0 0 0 0 0 0 0 0 0 0 0 0 0 0 
