31
20
20 20 20 20 20 20 20 20 20 20 20 20 20 20 20 20 20 20 20 20 20 20 20 20 20 20 20 20 20 20 20 
20 20 20 20 20 20 20 20 20 20 20 20 20 20 20 20 20 20 20 20 20 20 20 20 20 20 20 20 20 20 20 
20 20 20 20 20 3 3 3 3 3 3 3 3 3 3 3 3 3 3 3 3 3 3 3 3 20 20 20 20 20 20 
20 20 20 20 6 4 1 1 1 1 1 1 1 1 1 1 1 1 4 4 4 4 4 4 4 3 20 20 20 20 20 
20 20 20 6 1 1 1 1 1 1 1 1 1 1 1 1 1 1 1 1 1 1 1 1 1 1 1 20 20 20 20 
20 20 6 1 1 1 1 1 1 1 1 1 1 1 1 1 1 1 1 1 1 1 1 1 1 1 1 3 20 20 20 
20 20 6 1 1 1 1 1 1 1 1 1 1 1 1 1 1 1 1 1 1 1 1 1 1 1 1 1 3 20 20 
20 20 6 1 1 1 1 1 1 1 1 1 1 1 1 1 1 1 1 2 2 1 1 1 1 1 1 1 5 20 20 
20 6 1 1 1 21 1 21 1 21 21 21 1 1 1 1 1 1 2 28 28 1 1 1 1 1 1 1 5 20 20 
20 6 1 1 1 1 21 1 1 21 1 21 1 1 1 1 1 2 28 28 28 2 1 1 1 1 1 1 5 20 20 
20 6 1 1 1 1 21 1 1 21 21 21 1 1 1 1 5 28 28 28 28 28 1 1 1 1 1 1 5 20 20 
20 6 1 1 1 1 1 1 1 1 1 1 1 1 1 1 5 28 28 28 28 28 2 2 1 1 1 1 5 20 20 
20 6 1 1 1 1 1 1 1 1 1 1 1 1 1 1 5 28 28 28 28 28 28 28 6 1 1 1 5 20 20 
20 20 2 1 1 1 1 1 1 1 1 1 1 1 1 1 5 28 28 28 3 28 28 3 1 1 1 1 5 20 20 
20 20 20 2 1 1 1 1 1 1 1 1 1 1 1 1 1 3 28 3 1 3 3 1 1 1 1 2 2 20 20 
20 20 20 20 2 1 1 1 1 1 1 1 1 1 1 1 1 1 3 1 1 1 1 1 1 1 1 20 20 20 20 
20 20 20 20 20 2 1 1 1 1 1 1 1 1 1 1 1 1 1 1 1 1 1 1 2 2 20 20 20 20 20 
20 20 20 20 20 20 2 2 2 2 2 2 2 2 2 2 2 2 2 2 2 2 2 2 20 20 20 20 20 20 20 
20 20 20 20 20 20 20 20 20 20 20 20 20 20 20 20 20 20 20 20 20 20 20 20 20 20 20 20 20 20 20 
20 20 20 20 20 20 20 20 20 20 20 20 20 20 20 20 20 20 20 20 20 20 20 20 20 20 20 20 20 20 20 
