54
30
42 28 28 28 29 28 28 28 29 28 28 28 28 28 28 29 28 28 37 28 28 29 28 28 28 28 29 28 28 28 28 29 28 28 37 28 29 28 28 28 29 28 28 28 28 29 28 28 28 29 28 28 29 43 
36 7 7 7 7 7 7 7 7 7 7 7 7 7 7 7 7 7 36 41 41 41 41 41 41 7 7 7 7 7 7 25 7 7 36 7 7 7 7 7 7 7 25 25 25 25 25 25 25 7 41 41 41 36 
36 7 7 25 25 25 1 1 1 1 33 33 33 25 7 7 7 7 36 41 41 41 41 41 7 7 7 25 1 1 1 25 7 7 36 7 7 7 7 7 7 25 25 3 3 3 3 3 25 25 7 41 41 36 
36 7 7 25 25 1 1 26 1 4 5 33 33 25 25 7 7 7 36 41 41 7 7 7 7 7 7 25 26 33 33 1 7 7 36 7 7 7 7 25 25 25 3 1 2 2 1 1 3 25 25 41 41 36 
36 7 7 7 25 2 2 2 2 2 2 2 2 25 25 7 7 7 36 41 41 7 7 7 7 7 7 25 1 33 33 33 2 7 36 7 7 7 7 25 3 3 1 2 33 33 2 1 5 25 25 7 41 36 
36 7 7 7 25 25 25 25 25 25 25 25 25 25 25 7 7 7 35 41 7 7 7 7 7 7 7 25 2 2 26 2 25 7 36 7 7 7 25 25 6 4 5 33 33 33 33 6 5 25 7 7 41 36 
36 7 7 7 7 7 7 7 7 7 25 25 7 7 7 7 7 7 7 7 7 7 7 7 7 7 7 7 25 25 2 25 25 7 36 7 7 7 7 25 6 4 5 33 33 33 33 6 5 25 7 41 41 36 
36 7 7 7 7 7 7 7 7 7 7 7 7 7 7 7 7 7 7 7 7 7 7 7 7 7 7 7 7 7 7 7 7 7 36 7 7 7 7 25 2 2 26 33 33 33 6 2 25 25 7 41 41 36 
42 38 38 38 41 38 38 38 41 38 38 38 38 38 38 38 38 38 43 7 7 7 7 7 7 7 7 7 7 7 7 7 7 7 36 7 7 7 7 7 25 25 1 3 3 2 2 25 25 25 7 7 41 36 
36 7 7 7 7 7 7 7 7 7 7 7 7 44 44 7 7 7 36 7 7 7 7 7 7 7 7 7 7 7 7 7 7 7 36 7 7 7 7 7 25 25 2 2 2 25 25 25 7 7 7 7 7 36 
36 7 7 7 7 7 7 7 7 7 7 44 45 46 46 47 44 7 36 7 7 7 7 7 7 7 7 7 7 7 7 7 7 7 36 7 7 7 7 7 7 25 25 25 25 25 7 7 7 7 7 7 7 36 
36 41 41 7 7 7 7 7 7 7 7 7 7 7 7 7 7 7 7 7 7 7 7 7 7 7 7 7 7 7 7 7 7 7 36 41 41 41 41 7 7 25 7 7 7 7 7 7 7 7 7 7 7 36 
36 41 41 7 7 7 7 7 7 7 7 7 11 13 13 13 12 7 7 7 7 7 7 7 7 7 7 7 7 7 7 7 7 7 36 41 44 7 41 7 7 7 7 7 7 7 7 7 7 7 7 7 7 36 
36 41 41 41 7 7 7 7 7 7 7 7 8 9 9 9 10 7 36 7 7 7 7 7 7 7 7 7 7 7 7 7 7 7 36 41 7 7 7 7 7 7 7 7 7 7 7 7 7 7 7 7 7 36 
36 41 41 41 41 7 7 7 7 7 7 7 7 7 7 7 7 7 36 7 7 7 7 7 7 7 11 13 12 7 7 7 7 7 36 41 7 7 41 7 7 7 7 7 7 11 13 12 7 7 7 7 7 36 
42 38 38 38 38 38 38 38 38 38 38 41 38 38 38 38 41 38 38 38 38 38 41 29 38 38 8 9 10 38 38 41 38 29 38 38 38 38 38 38 41 38 38 38 38 8 9 10 38 38 41 38 38 36 
36 7 7 7 7 7 7 7 7 7 7 7 7 7 7 7 7 7 7 7 7 7 7 7 7 7 7 7 7 7 7 7 7 7 7 7 7 7 7 7 7 7 7 7 7 7 7 7 7 7 7 7 7 36 
36 7 7 7 7 7 7 7 25 25 25 25 25 25 25 7 7 7 7 7 7 7 7 7 7 7 7 7 7 7 7 7 7 7 7 7 7 7 7 7 7 7 7 7 7 7 7 7 7 7 7 7 7 36 
36 7 7 7 7 7 7 7 25 25 1 1 26 1 25 25 25 25 7 7 7 7 7 7 7 7 7 7 7 7 7 7 7 7 7 7 7 7 7 7 7 7 7 7 7 7 7 7 7 7 7 7 7 36 
36 7 7 11 13 12 7 7 25 25 2 2 2 26 1 1 25 25 7 7 7 7 7 7 7 7 7 7 7 7 7 7 7 7 7 7 7 7 7 7 7 7 7 7 7 7 7 7 7 7 7 7 7 36 
36 7 7 8 9 10 7 7 25 25 25 25 25 1 1 1 1 25 25 7 7 7 7 7 7 7 7 7 7 7 7 7 44 44 44 44 44 44 44 44 44 44 7 7 7 7 7 7 7 7 41 41 7 36 
36 7 7 7 7 7 7 7 7 7 7 7 25 1 26 26 1 1 25 25 7 7 7 7 7 7 7 7 7 7 7 45 46 46 46 46 46 46 46 46 46 46 47 7 7 7 7 7 7 41 41 7 7 36 
36 7 7 7 7 7 7 7 7 7 7 7 25 1 1 1 1 1 25 25 7 7 7 7 7 7 7 7 7 7 7 7 44 44 44 44 44 44 44 44 44 7 7 7 7 7 7 7 41 41 7 7 7 36 
36 41 41 7 7 7 7 44 45 47 7 7 25 2 2 2 2 2 25 25 7 7 7 7 7 7 7 7 7 7 7 7 7 7 7 7 7 7 7 7 7 7 7 7 7 7 7 7 41 7 7 7 7 36 
36 41 41 7 7 7 7 7 7 7 7 7 25 25 25 25 25 25 25 25 7 7 7 7 7 7 7 7 7 7 7 7 11 13 13 13 13 13 13 13 12 7 7 7 7 41 41 41 41 7 7 7 7 36 
36 41 41 41 41 41 7 7 7 7 7 7 25 25 25 25 25 25 25 7 7 7 7 7 7 7 7 7 7 7 7 7 8 9 9 9 9 9 9 9 10 7 7 7 41 41 7 7 7 7 7 7 44 36 
36 41 41 41 41 41 41 7 7 7 7 7 7 7 7 7 7 7 7 7 7 7 7 7 7 7 7 7 7 7 7 7 7 7 7 7 7 7 7 7 7 7 7 7 41 7 7 7 7 7 7 7 7 36 
36 41 41 41 41 41 41 41 41 41 7 7 7 7 7 7 7 7 7 7 7 7 7 7 7 7 7 7 7 7 7 7 7 7 7 7 7 7 7 7 7 7 7 7 41 7 7 7 7 44 7 7 7 36 
36 41 41 41 41 41 41 41 41 41 41 7 7 7 7 7 7 7 7 7 7 7 7 7 7 7 7 7 7 7 7 7 7 7 7 7 7 7 7 7 7 7 7 7 41 7 7 7 7 7 7 7 7 36 
27 27 27 27 27 27 27 27 27 27 27 27 27 27 27 27 27 27 27 27 27 27 27 27 27 27 27 27 27 27 27 27 27 27 27 27 27 27 27 27 27 27 27 27 27 27 27 27 27 27 27 27 27 27 
