54
30
25 25 25 25 25 25 25 25 25 25 25 25 25 25 25 25 25 25 25 25 25 25 25 25 25 25 25 25 25 25 25 25 25 25 25 25 25 25 25 25 25 25 25 25 25 25 25 25 25 25 25 25 25 25 
25 25 25 25 25 25 25 25 25 25 25 25 25 25 25 25 25 25 25 25 25 25 25 25 25 25 25 25 25 25 25 25 25 25 25 25 25 25 25 25 25 25 25 25 25 25 25 25 25 25 25 25 25 25 
25 25 25 25 25 25 25 3 3 3 3 3 3 3 3 3 3 3 3 3 3 3 3 3 3 3 3 3 3 3 3 3 3 3 3 3 3 3 3 3 3 3 3 3 3 3 3 3 25 25 25 25 25 25 
25 25 25 25 25 3 3 1 1 1 1 1 1 1 1 1 1 1 1 1 1 1 1 1 1 1 1 1 1 1 1 1 1 1 1 1 1 1 1 1 1 1 1 1 1 1 1 1 3 25 25 25 25 25 
25 25 25 25 3 1 1 1 1 1 1 1 1 1 1 1 1 1 1 1 1 1 1 1 1 1 1 1 1 1 1 1 1 1 26 26 26 1 1 1 1 1 1 1 1 1 1 1 1 3 25 25 25 25 
25 25 25 3 1 1 1 1 26 26 26 26 1 1 26 1 1 1 1 26 26 26 26 1 1 1 1 1 1 1 1 1 1 1 1 1 26 1 1 1 1 1 1 1 1 1 1 1 1 1 5 25 25 25 
25 25 1 1 1 1 1 1 26 1 1 1 1 1 26 1 1 1 1 26 1 1 26 1 1 1 1 1 1 1 1 1 1 1 1 1 26 26 26 1 1 1 1 1 1 1 1 1 1 1 5 25 25 25 
25 25 6 1 1 1 1 1 26 1 1 26 26 1 26 1 1 1 1 26 26 26 26 1 1 1 1 1 1 1 1 1 1 1 26 26 26 26 26 1 1 1 1 1 1 1 1 1 1 1 1 5 25 25 
25 25 6 1 1 1 1 1 26 1 1 26 1 1 26 1 1 1 1 26 1 1 1 1 1 1 1 1 1 1 1 1 1 1 26 26 26 26 26 1 1 1 1 1 1 1 1 1 1 1 1 5 25 25 
25 25 6 1 1 1 1 1 26 26 26 26 1 1 26 26 26 26 1 26 1 1 1 1 1 1 1 1 1 1 1 1 1 1 1 1 26 26 26 1 1 1 1 1 1 1 1 1 1 1 1 5 25 25 
25 25 6 1 1 1 1 1 1 1 1 1 1 1 1 1 1 1 1 1 1 1 1 1 1 1 1 1 1 1 1 1 1 1 1 1 1 1 1 1 1 1 1 1 1 1 1 1 1 1 1 5 25 25 
25 25 6 1 1 1 1 1 1 1 1 1 1 1 1 1 1 1 1 1 1 1 1 1 1 1 1 1 1 1 1 1 1 1 1 1 1 1 1 1 1 1 1 1 1 1 1 1 1 1 1 5 25 25 
25 25 6 1 1 1 1 1 1 1 1 1 1 1 1 1 1 1 1 1 1 1 1 1 1 1 1 1 1 1 1 1 1 1 1 1 1 1 1 1 1 1 1 1 1 1 1 1 1 1 1 5 25 25 
25 25 6 1 1 1 1 1 1 1 1 1 1 1 1 1 1 1 1 1 1 1 1 1 1 1 1 1 1 1 1 1 1 1 1 1 1 1 1 1 2 2 2 2 2 2 2 1 1 1 1 5 25 25 
25 25 6 1 1 1 1 1 1 1 1 1 1 1 1 1 1 1 1 1 1 1 1 1 26 1 1 1 1 1 1 1 1 1 1 1 1 1 1 2 33 33 33 33 33 33 33 6 1 1 1 5 25 25 
25 25 6 1 1 1 1 1 1 1 1 1 1 1 1 1 1 1 1 1 1 1 1 26 1 26 1 1 1 1 1 1 1 1 1 1 1 1 2 33 33 33 33 33 33 33 33 6 1 1 1 5 25 25 
25 25 6 1 1 1 1 1 1 1 1 1 1 1 1 1 1 1 1 1 1 1 1 1 26 1 26 1 1 1 1 1 1 1 1 1 1 5 33 33 33 33 33 33 33 33 33 26 1 1 1 5 25 25 
25 25 2 2 1 1 1 1 1 1 1 1 1 1 1 1 1 1 1 1 1 1 1 1 1 1 1 1 1 1 1 1 1 1 1 1 1 5 33 6 3 3 3 3 3 3 26 26 1 1 1 5 25 25 
25 25 25 25 6 1 1 1 1 1 1 1 1 1 1 2 2 2 2 2 1 1 1 1 1 1 1 1 1 1 1 1 1 1 1 1 1 5 33 6 1 1 1 1 1 1 1 1 1 1 1 5 25 25 
25 25 25 25 6 1 1 1 1 1 1 1 1 1 1 33 33 33 33 33 2 1 1 1 1 1 1 1 1 1 1 1 1 1 1 1 1 1 3 1 1 1 1 1 1 1 1 1 1 1 1 5 25 25 
25 25 25 25 6 1 1 1 1 1 1 1 1 1 5 33 33 33 33 33 33 6 1 1 1 1 1 1 1 1 1 1 1 1 1 1 1 1 1 1 1 1 1 1 1 1 1 1 1 1 1 5 25 25 
25 25 25 25 6 1 1 1 1 4 4 4 4 4 5 33 33 33 33 33 33 6 1 1 1 1 1 1 1 1 1 1 1 1 1 1 1 1 1 1 1 1 1 1 1 1 1 1 1 1 1 5 25 25 
25 25 25 6 1 1 1 1 1 4 4 4 4 4 1 3 3 3 33 33 33 1 1 1 1 1 1 1 1 1 1 1 1 1 1 1 1 1 1 1 1 1 1 1 1 1 1 1 1 1 1 5 25 25 
25 25 25 6 1 1 1 1 4 4 4 4 4 4 1 1 1 1 3 3 3 1 1 1 1 1 1 1 1 1 1 1 1 1 1 1 1 1 1 1 1 1 1 1 1 1 1 1 1 1 1 5 25 25 
25 25 25 6 1 1 1 4 1 4 4 4 4 4 1 1 1 1 1 1 1 1 1 1 1 1 1 1 1 1 1 1 1 1 1 1 1 1 1 1 1 1 1 1 1 1 1 1 1 1 1 5 25 25 
25 25 25 2 1 1 1 1 1 4 4 4 4 4 1 1 1 1 1 1 1 1 1 1 1 1 1 1 1 1 1 1 1 1 1 1 1 1 1 1 1 1 1 1 1 1 1 1 1 1 1 2 25 25 
25 25 25 25 2 1 1 1 1 1 1 1 4 4 1 1 1 1 1 1 1 1 1 1 1 1 1 1 1 1 1 1 1 1 1 1 1 1 1 1 1 1 1 1 2 2 2 2 2 2 2 25 25 25 
25 25 25 25 25 2 1 1 1 1 1 1 1 1 1 1 1 2 2 2 2 2 2 1 1 1 1 1 1 1 1 1 1 2 2 2 2 2 2 2 2 2 2 2 25 25 25 25 25 25 25 25 25 25 
25 25 25 25 25 25 2 2 2 2 2 2 2 2 2 2 2 25 25 25 25 25 25 2 2 2 2 2 2 2 2 2 2 25 25 25 25 25 25 25 25 25 25 25 25 25 25 25 25 25 25 25 25 25 
25 25 25 25 25 25 25 25 25 25 25 25 25 25 25 25 25 25 25 25 25 25 25 25 25 25 25 25 25 25 25 25 25 25 25 25 25 25 25 25 25 25 25 25 25 25 25 25 25 25 25 25 25 25 
